00000111*1
1011011001
0000011011
1110010011
1000010111
101101001
1000011101
1111000001
1000011000
1110111111

